1 1 1 1 1 1 1 1 1 1 1 1 1 1 1 1 1 1 1 1 1 1 1 1 1 1 1 1 1 1 1 1 1 1 1 1 1 1 1 1 1 1 1 1 1 1 1 1 1 1 
1 1 1 1 1 1 1 1 1 1 1 1 1 1 1 1 1 1 1 1 1 1 1 1 1 1 1 1 1 1 1 1 1 1 1 1 1 1 1 1 1 1 1 1 1 1 1 1 1 1 
1 1 1 1 1 1 1 1 1 1 1 1 1 1 1 1 1 1 1 1 1 1 1 1 1 1 1 1 1 1 1 1 1 1 1 1 1 1 1 1 1 1 1 1 1 1 1 1 1 1 
1 1 1 1 1 1 1 1 1 1 1 1 1 1 1 1 1 1 1 1 1 1 1 1 1 1 1 1 1 1 1 1 1 1 1 1 1 1 1 1 1 1 1 1 1 1 1 1 1 1 
1 1 1 1 1 1 1 1 1 1 1 1 1 1 1 1 1 1 1 1 1 1 1 1 1 1 1 1 1 1 1 1 1 1 1 1 1 1 1 1 1 1 1 1 1 1 1 1 1 1 
1 1 1 1 1 1 1 1 1 1 1 1 1 1 1 1 1 1 1 1 1 1 1 1 1 1 1 1 1 1 1 1 1 1 1 1 1 1 1 1 1 1 1 1 1 1 1 1 1 1 
1 1 1 1 1 1 1 1 1 1 1 1 1 1 1 1 1 1 1 1 1 1 1 1 1 1 1 1 1 1 1 1 1 1 1 1 1 1 1 1 1 1 1 1 1 1 1 1 1 1 
1 1 1 1 1 1 1 1 0 0 0 0 0 4 4 0 0 0 0 0 0 0 0 0 0 0 0 0 5 5 5 5 5 5 5 5 5 5 5 5 5 5 1 1 1 1 1 1 1 1 
1 1 1 1 1 1 1 1 0 0 0 0 0 4 4 4 0 0 0 0 0 0 0 0 0 0 0 0 0 0 0 4 5 5 5 5 5 5 5 5 5 5 1 1 1 1 1 1 1 1 
1 1 1 1 1 1 1 1 0 0 0 0 0 4 4 4 4 4 0 0 0 0 0 0 0 0 0 2 2 2 0 5 5 2 2 2 2 5 5 2 5 5 1 1 1 1 1 1 1 1 
1 1 1 1 1 1 1 1 0 4 5 5 5 4 4 4 5 5 7 7 5 5 5 5 0 0 0 2 0 0 0 5 5 2 2 5 5 7 0 2 0 5 1 1 1 1 1 1 1 1 
1 1 1 1 1 1 1 1 5 5 5 0 0 5 5 5 5 5 7 7 7 7 7 5 0 0 0 2 2 0 0 0 5 5 5 5 4 4 2 2 0 5 1 1 1 1 1 1 1 1 
1 1 1 1 1 1 1 1 5 5 5 0 4 0 4 4 5 5 7 7 4 4 4 0 0 0 0 0 2 2 2 5 5 5 5 5 5 5 2 2 0 5 1 1 1 1 1 1 1 1 
1 1 1 1 1 1 1 1 0 0 0 5 5 5 4 4 5 5 5 7 0 0 0 0 0 0 0 2 2 5 5 5 7 5 5 5 5 5 2 0 0 5 1 1 1 1 1 1 1 1 
1 1 1 1 1 1 1 1 5 5 5 5 5 5 5 5 5 5 5 5 5 5 5 0 0 0 2 0 2 4 4 4 5 5 5 5 5 5 5 0 5 5 1 1 1 1 1 1 1 1 
1 1 1 1 1 1 1 1 4 0 4 5 5 5 0 5 5 5 0 0 0 0 0 0 0 0 2 2 5 5 5 5 5 5 5 5 5 5 5 5 5 5 1 1 1 1 1 1 1 1 
1 1 1 1 1 1 1 1 0 4 4 0 0 0 0 2 2 2 2 0 2 2 2 2 4 0 0 0 0 0 0 0 0 0 0 0 0 0 0 0 0 0 1 1 1 1 1 1 1 1 
1 1 1 1 1 1 1 1 0 4 4 0 0 0 2 2 0 0 0 0 0 4 0 2 4 0 0 0 0 0 0 0 0 0 0 0 0 0 0 0 0 0 1 1 1 1 1 1 1 1 
1 1 1 1 1 1 1 1 0 4 4 0 0 2 2 0 0 0 5 5 6 4 0 2 0 0 0 4 4 0 0 0 0 0 0 0 5 5 5 0 5 5 1 1 1 1 1 1 1 1 
1 1 1 1 1 1 1 1 0 4 2 2 2 2 2 2 5 0 5 5 0 4 0 2 0 5 5 5 4 0 0 0 5 5 5 5 5 5 5 5 5 5 1 1 1 1 1 1 1 1 
1 1 1 1 1 1 1 1 0 2 2 0 0 2 2 6 5 5 5 5 0 2 2 2 2 5 5 5 4 7 7 5 7 0 0 5 5 0 5 5 5 5 1 1 1 1 1 1 1 1 
1 1 1 1 1 1 1 1 0 4 2 0 0 6 2 2 5 5 5 5 2 2 0 4 2 5 2 5 2 0 7 6 2 2 5 5 2 0 5 5 5 5 1 1 1 1 1 1 1 1 
1 1 1 1 1 1 1 1 0 4 4 4 0 0 0 0 5 5 5 5 0 0 0 5 5 5 0 5 2 2 2 4 2 5 5 2 2 7 2 5 5 5 1 1 1 1 1 1 1 1 
1 1 1 1 1 1 1 1 0 4 4 4 4 4 4 0 0 5 5 5 5 5 5 5 2 5 0 5 2 4 2 2 5 5 2 5 5 2 2 5 5 5 1 1 1 1 1 1 1 1 
1 1 1 1 1 1 1 1 4 4 0 0 0 4 4 0 0 5 5 5 5 0 0 0 2 5 0 5 2 0 4 5 5 2 2 2 2 2 2 5 5 5 1 1 1 1 1 1 1 1 
1 1 1 1 1 1 1 1 4 4 4 0 0 4 4 4 4 4 0 4 5 5 0 0 5 5 0 5 6 5 5 6 4 7 7 7 7 0 2 5 5 5 1 1 1 1 1 1 1 1 
1 1 1 1 1 1 1 1 4 4 4 4 4 4 0 4 4 0 0 0 4 5 5 5 5 5 2 5 5 5 0 0 0 0 0 0 0 0 0 5 5 5 1 1 1 1 1 1 1 1 
1 1 1 1 1 1 1 1 4 4 4 4 4 4 4 4 4 4 0 0 4 0 0 0 5 0 0 4 5 4 4 5 5 5 5 5 5 5 5 5 0 5 1 1 1 1 1 1 1 1 
1 1 1 1 1 1 1 1 4 4 4 4 0 0 4 0 4 4 4 2 2 0 0 6 5 5 6 5 5 5 4 4 0 0 0 0 0 5 5 5 0 5 1 1 1 1 1 1 1 1 
1 1 1 1 1 1 1 1 4 4 4 4 0 0 4 0 2 2 2 2 2 2 2 5 2 5 5 5 5 6 5 4 4 5 5 5 5 5 5 0 0 5 1 1 1 1 1 1 1 1 
1 1 1 1 1 1 1 1 4 4 4 4 0 4 2 2 2 2 2 2 2 2 0 5 7 6 6 5 5 5 5 4 4 0 0 5 5 0 0 0 0 5 1 1 1 1 1 1 1 1 
1 1 1 1 1 1 1 1 4 4 4 4 2 2 2 2 2 0 0 0 0 0 5 5 7 2 2 4 5 6 5 4 5 5 0 5 0 0 0 0 0 5 1 1 1 1 1 1 1 1 
1 1 1 1 1 1 1 1 4 4 4 0 0 2 2 2 0 0 0 5 2 5 5 7 0 0 0 4 5 0 5 4 5 5 5 5 0 0 0 0 0 5 1 1 1 1 1 1 1 1 
1 1 1 1 1 1 1 1 0 0 0 0 0 0 0 0 5 5 0 0 0 0 0 2 2 2 0 4 4 5 4 4 0 5 5 0 0 0 5 0 5 5 1 1 1 1 1 1 1 1 
1 1 1 1 1 1 1 1 3 3 0 0 0 0 0 5 5 5 5 5 2 0 0 0 0 0 0 0 4 4 4 4 5 5 5 0 0 0 5 0 5 0 1 1 1 1 1 1 1 1 
1 1 1 1 1 1 1 1 3 3 3 0 0 0 5 5 5 5 5 5 5 5 5 5 5 2 5 5 0 4 4 5 0 0 0 5 5 0 5 5 5 0 1 1 1 1 1 1 1 1 
1 1 1 1 1 1 1 1 3 3 3 0 0 5 5 5 5 5 5 5 5 5 5 0 0 0 0 0 0 0 6 6 0 0 0 0 5 7 7 0 0 0 1 1 1 1 1 1 1 1 
1 1 1 1 1 1 1 1 3 3 3 0 0 5 0 0 5 5 5 5 5 0 5 0 0 0 0 0 5 0 0 0 0 6 0 0 0 7 7 0 0 0 1 1 1 1 1 1 1 1 
1 1 1 1 1 1 1 1 3 3 3 3 0 5 5 0 0 5 5 5 5 0 5 0 0 0 0 6 0 5 5 5 5 6 6 7 7 7 7 0 0 0 1 1 1 1 1 1 1 1 
1 1 1 1 1 1 1 1 3 3 3 3 3 3 5 0 0 0 5 5 5 0 0 0 0 5 5 5 5 6 0 0 5 5 6 7 7 7 7 0 0 0 1 1 1 1 1 1 1 1 
1 1 1 1 1 1 1 1 3 3 3 3 0 3 5 5 5 0 0 5 5 0 0 5 0 5 5 5 6 6 6 6 6 5 5 5 7 7 7 0 0 0 1 1 1 1 1 1 1 1 
1 1 1 1 1 1 1 1 3 3 3 3 0 0 3 3 5 5 5 5 5 5 0 5 0 0 6 5 5 5 5 5 5 5 5 5 7 7 7 0 0 0 1 1 1 1 1 1 1 1 
1 1 1 1 1 1 1 1 3 3 3 3 3 3 3 0 3 0 0 0 0 5 5 5 5 5 5 5 5 5 5 5 5 5 5 5 0 7 0 0 0 0 1 1 1 1 1 1 1 1 
1 1 1 1 1 1 1 1 1 1 1 1 1 1 1 1 1 1 1 1 1 1 1 1 1 1 1 1 1 1 1 1 1 1 1 1 1 1 1 1 1 1 1 1 1 1 1 1 1 1 
1 1 1 1 1 1 1 1 1 1 1 1 1 1 1 1 1 1 1 1 1 1 1 1 1 1 1 1 1 1 1 1 1 1 1 1 1 1 1 1 1 1 1 1 1 1 1 1 1 1 
1 1 1 1 1 1 1 1 1 1 1 1 1 1 1 1 1 1 1 1 1 1 1 1 1 1 1 1 1 1 1 1 1 1 1 1 1 1 1 1 1 1 1 1 1 1 1 1 1 1 
1 1 1 1 1 1 1 1 1 1 1 1 1 1 1 1 1 1 1 1 1 1 1 1 1 1 1 1 1 1 1 1 1 1 1 1 1 1 1 1 1 1 1 1 1 1 1 1 1 1 
1 1 1 1 1 1 1 1 1 1 1 1 1 1 1 1 1 1 1 1 1 1 1 1 1 1 1 1 1 1 1 1 1 1 1 1 1 1 1 1 1 1 1 1 1 1 1 1 1 1 
1 1 1 1 1 1 1 1 1 1 1 1 1 1 1 1 1 1 1 1 1 1 1 1 1 1 1 1 1 1 1 1 1 1 1 1 1 1 1 1 1 1 1 1 1 1 1 1 1 1 
1 1 1 1 1 1 1 1 1 1 1 1 1 1 1 1 1 1 1 1 1 1 1 1 1 1 1 1 1 1 1 1 1 1 1 1 1 1 1 1 1 1 1 1 1 1 1 1 1 1 
